1 1 1 7 7 
1111111
1400001
1000001
1003001
1002001
1000001
1111111