4 1 2 8 8 
11111111
10004001
10211011
10000001
11111001
10020001
10000331
11111111