1 2 4 8 8 
11111000
11001   
14021   
112011  
100201  
102001
133331  
111111  