7 3 4 12 7 
111111111111
110000001111 
112111000011
100020042011
103310200111
113310001111
111111111111 